NO ./StoneHitler.xpm
SO ./wall.xpm
WE ./Blue.xpm
EA ./Stoneflag.xpm

C 102,178,255
F 64,64,64

        1111111111111111111111111111111111
1111111  100000000000000000000000011
10000011110010000000000000011100011
10000000001000000000100001111111111
10001111111000000000001000000000011
11111111100000010000000000001111111
1000000000001000000N00000001111111
111111111000000100000000000000011
1000000000001000000000000001111111
10000000000000100000000000011
100000000000000000010100000111
110000011101010111110111111011
11111111 1110111 1011110100011
         1111111 1111111111111