NO ./StoneHitler.xpm
SO ./wall.xpm
WE ./Blue.xpm
EA ./Stoneflag.xpm

C 102,178,255
F 64,64,64

        1111111111111111111111111111111111
1111111  10000000000000000000000001
10000011110010000000000000011100011
10000000001000000000100001111111111
10001111111000000000001000000000011
11111111100000010000000000001111111
100000000000100000N00000001111111
111111111110000100000000000000011
111100001 10001000000000000001111111
  111110111100000100000000000011
1110000000000000000101000001111
11000001110101011111011111011
11111111 1110111 1011110100011
         1111111 1111110111111