NO ./img/NO.xpm
SO ./img/SO.xpm
WE ./img/WE.xpm
EA ./img/EA.xpm

F ./img_bonus/floor.xpm
C ./img_bonus/skybox.xpm

11111111111111111111111111111111
1B000000000000000000000000000001
11111111111111111111111000000001
10000001000000000000001000000001
100000010000010000000010000000O1
10000001000001000000001000000001
10000001000001000000001000E00001
10000001000001000000001000000001
10000001000001000111111000000001
10000001000001000000001000000001
10000001111111000000001000000001
10000001000001000000001000000001
10000001000G01000000001000000001
10000001000001000000001000000001
10000001000001000000001000000001
10000001000001001111111000000001
10000001000001000000001000000001
10000001000001000000001000000001
10000001000001000000001000000001
10000100000000000000000000001001
11110111111111111111111111001001
1R000000000000000000001H000010Y1
11111111111111111111111111111111